YSN = "countries/Yoshino.txt" #四糸乃
PRA = "countries/Paradox Interactive.txt" #P社
AOG = "countries/Ainz Ooal Gown.txt" #安兹乌尔恭
ABD = "countries/Albedo.txt" #雅儿贝德
STR = "countries/Shalltear bloodfallen.txt" #夏提雅
CCT = "countries/Cocytus.txt" #科赛特斯
DMU = "countries/Demiurge.txt" #迪米乌哥斯
NSL = "countries/Nasalik.txt" #纳萨力克-endtag
INX = "countries/Indexs.txt" #茵蒂克丝
MSK = "countries/Misaka Mikoto.txt" #御坂美琴
SHI = "countries/Shirai Kuroko.txt" #白井黑子
HUH = "countries/Huihui.txt" #慧慧
MDK = "countries/Kaname Madoka.txt" #鹿目圆
AKE = "countries/Akemi Homura.txt" #晓美焰
SAY = "countries/Miki Sayaka.txt" #美树沙耶加
TOM = "countries/Tomoe Mam.txt" #巴麻美
KYO = "countries/Sakura Kyouko.txt" #佐仓杏子
MUS = "countries/Us forever.txt" #缪斯
AQO = "countries/Aqours.txt" #水团
PLE = "countries/Pleiades.txt" #昴宿星团
SEB = "countries/Sebas Tian.txt" #赛巴斯
HTS = "countries/Hatsune Miku.txt" #初音未来
LTY = "countries/Luotianyi.txt" #洛天依
YZL = "countries/YueZhengLing.txt" #乐正绫
DJD = "countries/DarkJeanne d'Arc.txt" #贞德 Alter
MTE = "countries/Matthew Kyrielite.txt" #玛修
RIN = "countries/Tohsaka Rin.txt" #远坂凛
ATR = "countries/Altria Pendragon.txt" #阿尔托莉雅-潘德拉贡
OKT = "countries/Okita Souji.txt" #冲田总司
NER = "countries/Nero Claudius.txt" #尼禄-克劳狄乌斯
HKR = "countries/Hakurei Reimu.txt" #博丽灵梦
MRS = "countries/Kirisame Marisa.txt" #雾雨魔理沙
YKR = "countries/Yakumo Yukari.txt" #八云紫
QLN = "countries/Cirno.txt" #琪露诺
KMJ = "countries/Komeiji.txt" #古明地觉
RML = "countries/Remilia Scarlet.txt" #蕾米莉亚-斯卡雷特
SKY = "countries/Izayoi Sakuya.txt" #十六夜咲夜
FLD = "countries/Flandre Scarlet.txt" #芙兰朵露-斯卡雷特
YYK = "countries/Saigyouji Yuyuko.txt" #西行寺幽幽子
PCL = "countries/Patchouli Knowledge.txt" #帕秋莉诺雷姬
LLF = "countries/LoveLiveFederal.txt" #LL联邦-endtag
RIB = "countries/Rheinbund.txt" #莱茵联盟
EBS = "countries/Ebisuzawa Kurumi.txt" #惠飞须泽胡桃
CTL = "countries/Chtholly Nota Seniorious.txt" #珂朵莉-瑟尼欧尼斯
KRE = "countries/Kujo Karen.txt" #九条可怜
AOB = "countries/Suzukaze aoba.txt" #凉风青叶
CHN = "countries/Kafuu Chino.txt" #香风智乃
SM0 = "countries/Madoka kami.txt" #神圣圆香帝国-endtag
SKR = "countries/Kinomoto Sakura.txt" #木之本樱
RDI = "countries/Rhodes Island.txt" #罗德岛
MMN = "countries/Momoe Nagisa.txt" #百江渚
TYA = "countries/Tanya.txt" #谭雅-预计搬家
YSK = "countries/Yasaka Kanako.txt" #八坂神奈子
KTY = "countries/Kotiya Sanae.txt" #东风谷早苗
MRY = "countries/Moriya Suwako.txt" #泄矢诹访子
RSK = "countries/RyougiShiKi.txt" #两仪式
SRA = "countries/Sora.txt" #空
SIR = "countries/Shiro.txt" #白
ELZ = "countries/Elzia.txt" #空白
TSA = "countries/Anastasia.txt" #阿纳斯塔西娅
MTM = "countries/Yakumo Mitama.txt" #八云御魂
HML = "countries/Hong MeiLing.txt" #红美玲
YOM = "countries/Konpaku Youmu.txt" #魂魄妖梦
ALC = "countries/Alice Margatroid.txt" #爱丽丝-玛格特罗依德
KGY = "countries/Houraisan Kaguya.txt" #蓬莱山辉夜
NMK = "countries/Fujiwara no mokou.txt" #藤原妹红
YUK = "countries/Kazami Yuuka.txt" #风见幽香
IBK = "countries/Ibuki Suika.txt"  #伊吹萃香
TES = "countries/Hinanawi Tenshi.txt" #比那名居天子
SJY = "countries/Shikieiki Yamaxanadu.txt" #四季映姬
SMM = "countries/Shameimaru Aya.txt" #射命丸文
EIR = "countries/Yagokoro Eirin.txt" #八意永琳
RES = "countries/Reisen Udongein Inaba.txt" #铃仙·优昙华院·因幡
IKR = "countries/Ikaros.txt" #伊卡洛斯
DTR = "countries/Dark altria Pendragon.txt" #阿尔托莉雅Alter-endtag
IST = "countries/Ishtar.txt"  #伊什塔尔-endtag
ELE = "countries/Ereshkigal.txt" #埃列什基伽勒-endtag
KMK = "countries/Koumakan.txt" #红魔馆-endtag
KDE = "countries/Kanade.txt" #立华奏
KRF = "countries/Kirara Fantasia.txt" #奇拉拉
ACV = "countries/Anchovy.txt"
HDM = "countries/Hidamari Yuno.txt" #由乃
SMR = "countries/Shima Rin.txt" #志摩凛
SMK = "countries/Yoshida Yuuko.txt" #吉田优子
NHY = "countries/Nonohara Yuzuko.txt" #野野原柚子
IRH = "countries/Tamaki Iroha.txt" #环伊吕波
RIK = "countries/Takanashi Rikka.txt" #小鸟游六花
YRN = "countries/Hanazono Yurine.txt" #花园百合铃
JSC = "countries/Jashinchan.txt" #邪神酱
DKM = "countries/Dekomori Sanae.txt" #凸守早苗
STM = "countries/Satomi Touka.txt" #里见灯花
MIF = "countries/Azusa Mifuyu.txt" #梓美冬
KML = "countries/Koishi.txt" #古明地恋
MJL = "countries/EarthSpiritHall.txt" #地灵殿-endtag
MRM = "countries/Murasame.txt" #丛雨
MKM = "countries/Mitsukasa Ayase.txt" #三司绫濑
OKK = "countries/Onozuka Komachi.txt" #小野冢小町
HNK = "countries/Hata no kokoro.txt" #秦心
CII = "countries/Chii.txt" #小叽
YMI = "countries/Yumemi.txt" #星野梦美
YAY = "countries/Yaya.txt" #夜夜
RLU = "countries/Rilulu.txt" #莉露露
SHW = "countries/Schwi_Dola.txt" #休比多拉
HME = "countries/Holy_Muse_Empire.txt" #神圣缪斯帝国-endtag
ELN = "countries/Elaina.txt" #伊蕾娜
SNK = "countries/Nibutani Shinka.txt" #丹生谷森夏
HCA = "countries/Hoto Cocoa.txt" #保登心爱-endtag
TRZ = "countries/Tedeza Rize.txt" #天天座理世-endtag
UJC = "countries/Ujimatsu Chiya.txt" #宇治松千夜-endtag
KSR = "countries/Kirima Syaro.txt" #桐间纱路-endtag
BBT = "countries/evil spirits of Tower of Babel.txt" #巴别塔-endtag
REU = "countries/reunion.txt" #整合运动-endtag
AL1 = "countries/REU Alina.txt" #阿丽娜-endtag
BKT = "countries/Buldrokkas_tee.txt" #博卓卡斯替-endtag
FON = "countries/FrostNova.txt" #霜星-endtag
TLL = "countries/Talulah.txt" #塔露拉-endtag
LSW = "countries/YueZhengLongya.txt" #乐正龙牙
DCT = "countries/YanHe.txt" #言和
XTC = "countries/ZhiyuMoke.txt" #徵羽摩柯
YSZ = "countries/Moqingxian.txt" #墨清弦
NJK = "countries/nijisaki.txt" #虹咲-endtag
PLP = "countries/Planeptune.txt" #涅普顿
LAS = "countries/Lastation.txt" #诺瓦露
LW1 = "countries/Lowee.txt" #路威
LBX = "countries/Leanbox.txt" #琳妮
EDE = "countries/Eden.txt" #超次元海王星tag
REI = "countries/Tari.txt" #超次元海王星tag
HDS = "countries/Heart_Dimension.txt" #圣黑之心-endtag
GTH = "countries/Gold_Third.txt" #绀紫之心-endtag
IMS = "countries/Idol master.txt" #偶像大师
TAS = "countries/TanyaReich.txt" #谭雅帝国-endtag
TKK = "countries/Toshino Kyoko.txt" #岁纳京子
FNY = "countries/Funami Yui.txt" #船见结衣
AKR = "countries/Akaza Akari.txt" #赤座灯里 
YKC = "countries/Yoshikawa Chinatsu.txt" #吉川千夏
NNH = "countries/Nanoha Takamachi.txt" #高町奈叶
LYZ = "countries/LieYongzhou.txt" #烈海王
LHW = "countries/LieHaiwang.txt" #烈海皇-endtag
YUI = "countries/Hirasawa Yui.txt" #平泽唯
JNR = "countries/Warship Girls.txt" #战舰少女R
JNB = "countries/Azur Lane.txt" #碧蓝航线
JNC = "countries/Kantai Collection.txt" #舰队Collection
GDR = "countries/Gilles de Rais.txt" #吉尔德雷
NNM = "countries/Nanami Yachiyo.txt" #七海八千代
FLC = "countries/Mitsuki Felicia.txt" #深月菲莉希亚
FTB = "countries/Futaba Sana.txt" #二叶纱奈
TRN = "countries/Yui Tsuruno.txt" #由比鹤乃
HRG = "countries/Hiiragi Nemu.txt" #柊音梦
GRY = "countries/Alina Gray.txt" #阿莉娜格雷
SLU = "countries/Signal light.txt" #更改-和泉十七夜
TKT = "countries/Tokai Teio.txt" #东海帝王
MMQ = "countries/Mejiro McQueen.txt" #目白麦昆
KTK = "countries/Kitasan Black.txt" #北部玄驹
STD = "countries/Satono Diamond.txt" #里见光钻
SPW = "countries/Special Week.txt" #特别周
SLS = "countries/Silence Suzuka.txt" #无声铃鹿
#————神罗————
AGA = "countries/Asagiri Aya.txt" #朝雾彩
AZN = "countries/Anazawa Nijimi.txt" #穴泽虹海
AZS = "countries/Azusa Aizawa.txt" #亚梓莎
BT1 = "countries/Beatrice.txt" #碧翠丝
CLE = "countries/Chloe von Einzbern.txt" #克洛伊 
ERG = "countries/Eris Greyrat.txt" #艾莉丝
EMM = "countries/Miyu Edelfelt.txt" #美游
FRR = "countries/Frieren.txt" #芙莉莲
ILY = "countries/Illyasviel von Einzbern.txt" #伊莉雅
IZF = "countries/Inubozaki Fu.txt" #犬吠埼风
IZI = "countries/Inubozaki Itsuki.txt" #犬吠埼树
KHT = "countries/Kashiwazaki Hatsune.txt" #帕琪初音
KRU = "countries/Karyl.txt" #凯露
KSY = "countries/Kusano Yui.txt" #草野优衣
KYM = "countries/Kuriyama Mirai.txt" #栗山未来
MYK = "countries/Miyoshi Karin.txt" #三好夏凛
NGS = "countries/Nogi Sonoko.txt" #乃木园子
ROX = "countries/Roxy Migurdia Greyrat.txt" #洛琪希
SCM = "countries/Shichimiya Satone.txt" #七宫智音
SHR = "countries/Shioi Rina.txt" #潮井梨奈
SYA = "countries/Saya.txt" #沙耶
SYL = "countries/Sylphiette Greyrat.txt" #希露菲叶特
TGM = "countries/Togo Mimori.txt" #东乡美森
YKY = "countries/Yuki Yuna.txt" #结城友奈
YMT = "countries/Yatsumura Tsuyuno.txt" #奴村露乃
LIS = "countries/Louise.txt" #露易丝
SKM = "countries/Shokuho Misaki.txt" #食蜂操祈
TMY = "countries/Tomoyo.txt" #大道寺知世
EMT = "countries/Emilia.txt" #爱蜜莉雅
RRN = "countries/Ryugu Rena.txt" #龙宫礼奈
SL9 = "countries/StarLight99.txt" #StarLight99组
MIH = "countries/Nishizumi Miho.txt" #西住美穗
KQS = "countries/Katyusha.txt" #喀秋莎
BDR = "countries/BangDoRi.txt" #邦多利
ATD = "countries/Astarte.txt"  #阿斯特拉-远坂凛endtag
#新加
KMG = "countries/Inukai Komugi.txt"	#犬饲小麦
SLH = "countries/Sora Harewataru.txt"	#索拉·哈雷瓦塔尔
NGY = "countries/Nagomi Yui.txt"	#和实由衣
HNA = "countries/Hieda no Akyuu.txt"	#稗田阿求
KZK = "countries/Kamishirasawa Keine.txt"	#上白泽慧音
IRK = "countries/Ibaraki Kasen.txt"	#茨木华扇
HSY = "countries/Hoshiguma Yuugi.txt"	#星熊勇仪
WNY = "countries/Watatsuki no Yorihime.txt"	#绵月依姬
WNT = "countries/Watatsuki no Toyohime.txt"	#绵月丰姬
KSN = "countries/Kawashiro Nitori.txt"	#河城荷取
HKH = "countries/Himekaido Hatate.txt"	#姬海棠果
ABY = "countries/Abydos.txt"	#阿拜多斯
MLN = "countries/Millennium.txt"	#千年
ARU = "countries/Arius.txt"	#阿里乌斯
TRG = "countries/Trinity.txt"	#圣三一
SHJ = "countries/Shanhaijing.txt"	#山海经
HKY = "countries/Hyakkiyako.txt"	#百鬼夜行
SCL = "countries/Schale.txt"	#夏莱
SRT = "countries/SRT_c.txt"	#SRT
VKR = "countries/Valkyrie.txt"	#瓦尔基里
GHN = "countries/Gehenna.txt"	#格黑娜
RWF = "countries/Red Winter.txt"	#赤冬
ODN = "countries/Oda Nobuna.txt"	#织田信奈
YKM = "countries/Yuki Makoto.txt"	#结城理
NKY = "countries/Narukami Yuu.txt"	#鸣上悠
AMR = "countries/Amamiya Ren.txt"	#雨宫莲
SKJ = "countries/Sakai Jin.txt"		#境井仁
KYR = "countries/Kayamori Ruka.txt"	#茅森月歌
#芳文新增
MTK = "countries/Etoilia.txt"	#艾特瓦利亚-endtag
KMR = "countries/Konohata Mira.txt" #木之幡米拉
MKK = "countries/Moeta Kaoruko.txt" #萌田薰子
ICT = "countries/Ichii Tooru.txt" #一井透
HDT = "countries/Honda Tamaki.txt"	#本田珠辉
CIY = "countries/Chiya.txt"	#千矢
OYN = "countries/Oribe Yasuna.txt"	#折部安奈
HRK = "countries/Takayama Haruka.txt"	#高山春香
SKN = "countries/Sakuranomiya Maika.txt"	#樱之宫莓香
INH = "countries/Ichinose Hana.txt"		#一之濑花名
YGK = "countries/Yamaguchi Kisaragi.txt"	#山口如月
MRN = "countries/Mary Nightmare.txt"	#玛丽梦魔
SEK = "countries/Sekiya Naru.txt"	#关谷鸣
HIA = "countries/Hanakoizumi An.txt"	#花小泉杏
OZH = "countries/Oozora Haruka.txt"	#大空遥
HYK = "countries/Hatoya Kohane.txt"	#鸠谷小羽
NSY = "countries/Nishikawa Yoko.txt"	#西川叶子
HSH = "countries/Hosono Harumi.txt"	#细野晴海
MCR = "countries/Machiko Ryou.txt"	#町子凉
TKY = "countries/Takeda Yomi.txt"	#武田咏深
SKI = "countries/Sakura Ino.txt"	#樱衣乃
MNT = "countries/Miniwa Tsumiki.txt"	#御庭摘希
BTR = "countries/Gotou Hitori.txt"	#后藤一里
MNK = "countries/Minagi Koharu.txt"	#海凪小春
KHU = "countries/Konohoshi Umika.txt"	#小之星海果
ESA = "countries/Etoilia Space Agency.txt"	#艾特瓦利亚空间科学研究所代管区
#后续新增
NBL = "countries/NewHakurei Reimu.txt" #灵梦
CRM = "countries/Crimvael.txt" #可利姆
STN = "countries/Stunk.txt" #史坦克
ZEL = "countries/Zel.txt" #杰尔
ATI = "countries/Atri.txt" #亚托莉
SKU = "countries/Ishigami Senkun.txt" #石神千空
TKS = "countries/Shishio Tsukasa.txt" #狮子王司
IYS = "countries/Inuyasha.txt" #犬夜叉
#特殊情况,覆盖原版tag，ENG,FRA,MNG,PAP,存疑，PAL,POL,POR,PRO,RYA,SAX,SIL,SWE,TIM,TRA,TRE,TRI,TUR
#通用理念：fgo文化组，东方文化组，二次元通用
